# Free Java Report

# editor button caption
editor\ title = rapport desginer
btnLineCaption = ligne
btnCellCaption = cellule
btnClearCaption = clair
btnEditCaption = rviser
btnPageCaption = page
btnPrintCaption = caractres
btnSaveCaption = sauver
btnLoadCaption = ouvert


btnOKCaption = confirmer
btnCancelCaption = annuler

# editor button tooltips
btnLineHint = configurate proprit17 de ligne
btnClearHint = enlevez toutes les lignes et les cellules
btnCellHint = configurate proprit17 de cellule
btnEditHint = rviser rapport
btnPageHint =  organisation de format de page
btnPrintHint = imprimez le rapport
btnCloseHint = sortie
btnSaveHint = sauvez au dossier
btnLoadHint = lisez du dossier

removePageHint = enlevez la page actuelle
newPageHint = insrez une nouvelle page
nextPageHint = page suivante
prePageHint = page prcdente
firstPageHint = goto first page
lastPageHint = allez 17 la premire page
btnBoldHint = fonte audacieuse
btnItalicHint = fonte italique
btnLeftHint = alignement gauche 
btnCenterHint = alignement de centre
btnRightHint = alignement juste

comboFontHint = choisissez la fonte
comboSizeHint = choisissez la grandeur de fonte

drawLineStatus = ligne d'attraction
desginCellStatus = grilles de design
editStatus = rviser
clearStatus = clair complet

#messages
confirmDeletePageMsg = tes-vous srs d'enlever cette page?
confirmDeletePageDlgTitle = effacez confirment
confirmClearPageMsg = tes-vous srs de dgager cette page ?
confirmClearPageDlgTitle = clair confirment

#Line Editor
lineEditorLableLine = courant: 
lineEditorTypeTitle = Type
lineEditorWidthTitle = Largeur
lineEditorInvisibleCaption = Invisible
lineEditorTitle = Proprits de Ligne

#Cell Editor
cellEditorName =nom
cellEditorContent=valeur
cellEditorType=type
cellEditorOption=combo options
cellEditorTitle=proprits de cellule
cellEditorMargin=marge
cellTopMargin=haut
cellLeftMargin=gauche
cellBottomMargin=fond
cellRightMargin=juste

#cell type description
cellType0=empty
cellType1=label
cellType2=textField
cellType3=textArea
cellType4=comboBox
cellType5=checkBox
cellType6=dateField
cellType7=image
cellType8=custom

#datePicker 
dayOfWeekName = D L M M J V S
invalidDateFormatMsg = Format sans fondement de ficelle de date.

#paged table print, Setting table column visibilities
columnVisibleTbTitle1 = visible
columnVisibleTbTitle2 = titre de colonne
columnVisibleDlgTitle = configurate visibilit17 de colonne


#about dialog
rights=tous droits rservs


#multi page message
pageMessage = page %p of %totalpage